Use Case ID,P-001,P-002,P-004,P-005,P-006,Total
UC-001,5,2,0,1,5,13
UC-002,0,0,0,1,0,1
UC-003,0,2,0,0,6,8
UC-004,0,1,0,0,0,1
UC-005,7,1,0,1,6,15
UC-006,3,0,1,3,7,14
UC-007,8,0,0,0,8,16
UC-008,0,2,1,1,6,10
UC-009,0,0,0,2,8,10
UC-010,7,0,0,2,0,9
UC-011,7,0,1,1,0,9
UC-012,7,0,0,2,0,9
UC-013,0,2,0,0,9,11
UC-014,0,1,0,0,0,1
UC-015,5,2,0,0,5,12
Total,49,13,3,14,60,139
